1111111111111111111111111111
1000000000000000000000000001
1011111111011111101111111101
1011111110000000000111111101
1011111100111111110011111101
1011111001110000111001111101
1011110011100110011100111101
1011100111001111001110011101
1011001110011111100111001101
1011011110111111110111101101
1000010000111111110000100001
1111110110000000000110111111
1111110110112222110110111111
1111110110112222110110111111
0000000000112222110000000000
1111110110111111110110111111
1111110110111111110110111111
1111110110000300000110111111
1000000000000000000000000001
1011110011000111101011111101
1011110111100110001011111101
1011100111100110001011111101
1011001100110110001000000001
1011001100110111101110111101
1000000000000000000010111101
1010001000110001001010111101
1010001001111001101010111101
1011111001111001011010000001
1010001011001101001011111101
1000000000000000000000000001
1111111111111111111111111111