1111111111111111111111111111
1000000000000000000000000001
1011110110111111110110111101
1011110110111111110110111101
1000110110110000110110110001
1110110110110110110110110111
1110110110110110110110110111
1110110110110110110110110111
1110000110000110000110000111
1110111110111111110111110111
1110111110111111110111110111
1000000000000000000000000001
1011111110111221110111111101
1011111110112222110111111101
1000110000112222110000110001
1110110110111111110110110111
1110110110111111110110110111
0000000110000300000110000000
1110110111110110111110110111
1110110111110110111110110111
1000110110000110000110110001
1011110110111111110110111101
1011110110111111110110111101
1000000000000000000000000001
1011110110111111110110111101
1011110110111111110110111101
1011000110000110000110001101
1011011110110110110111101101
1011011110110110110111101101
1000000000110000110000000001
1111111111111111111111111111
