1011111111111111111111111101
1000000000000000000000000001
1111111111111101111111111111
1111111111100000001111111111
1000000000001111100000000001
1111111111100000001111111111
1111111111111101111111111111
1000000000000000000000000001
1011111110111111110111111101
1011111110111111110111111101
1011111110111111110111111101
1000000000000000000000000001
1111111110112222110111111101
1000000000112222110111111101
1011111110112222110111111101
1011111110111111110000000001
1011111110111111111111111101
1000000000000300000000000001
1111111111101110111111111111
1000000000001110000000000001
1011111111101110111111111101
1000000000001110000000000001
1110111111101110111111110111
1110100000101110100000010111
1110101110100000101111010111
1110100000001110000000010111
1110111111111111111111110111
1110111111111111111111110111
1000000000000000000000000001
1011111111111111111111111101
1011111111111111111111111101