1111111111111111111111111111
1000000000111111110000000001
1011111110000000000111111101
1010000000111011110000000101
1000111110001001000111110001
1010111111101101011111110101
1010000000100000010000000101
1011111110111111110111111101
1000000000000000000000000001
1011011110111111110111101101
1000010000111111110000100001
1111110110000000000110111111
1111110110112222110110111111
1111110110112222110110111111
0000000000112222110000000000
1111110110111111110110111111
1111110110111111110110111111
1111110110000300000110111111
1000010000101111010000100001
1011011111100000011111101101
1000000000001111000000000001
1011111110111111110111111101
1010000000100000010000000101
1010111111101101011111110101
1000111110001001000111110001
1010000000111011110000000101
1011111110000000000111111101
1000000000111111110000000001
1011111110111111110111111101
1000000000000000000000000001
1111111111111111111111111111