1011111111111111111111111101
1000000000000000000000000001
1111111111110110111111111111
1000000000000110000000000001
1011111111111111111111111101
1000000000000000000000000001
1111111111110110111111111111
1000000000000000000000000001
1011111111111111111111111101
1000000000000000000000000001
1011111011111111111101111101
1000000000000000000000000001
1111111110112222110111111111
1111111110112222110111111111
1111111110112222110111111111
1111111110111111110111111111
1111111110111111110111111111
1000000000000300000000000001
1011111111111111111111110101
1000000000000000000000000101
1010101111111111111111110101
1010100000000000000000010101
1010111101010101010101010101
1010111101010101010101010101
1010111101010101010101010101
1010100000000000000000010101
1010101111111111111111110101
1010000000000000000000000001
1010111111111111111111111101
1000000000000000000000000001
1011111111111111111111111101